11111111111111111111
100E1101000C10001001
110001100100110000C1
10000000C000C0000001
11000C00101000000101
111PC001010010000101
10110110C00010001001
110000001001100C0C01
11000000C00000000011
11111111111111111111