1111111111111111111111111111111111111111111111111111111111111111111111111111111111111111111111111111
11000C000000000000000000000001100000C100010000000000000000100001000100100000000100100000100101000101
1011000100010110000100010100001010000000001011001C100000C0000010100C000001010000000001000C0101000111
100000101010000001C000000000C000010000000000000C010000010000001000C00110C000000001101000000000001011
10100C010C0C10CC000000000000000100101001100001000000000C101111100000100010100010101C0000010010100001
100000001000010000100100C01001000C100001C000C10000C010C0000001011000100110000001C0001001000010010001
10110C00101000000000001C000010000000110000001000000000100000000000000110C0100010001C00100001000C0101
1000001000001100000010000000110001001100000C00C00000000000C01001000000000010001000000011000010010001
10010C0100000101100000000011100000000100110000000001000000010000001001000010100000C01010001100100001
10010C100000C0000000C010010001100C01100001C000000000001000000000000000000000000010000000100011C00011
100010001000010000000000100000100101100000000000000110000011000C0011000001010010001000110000C1010001
10000000000000000011000001C100010000100010000000000C0000C0000000001C000010100C0000010010010C00000001
101100C100001010000000001101000101000000000000001100000000000000100000100C0C110000001000000110010001
10000000001100011010000C00010010001000000000010010001001001011100C1100010000000000010000010000000001
1001C1C011C010000000100C00010C0001000000C101000000001011000100100100010001000000000000001000C0001001
1C0000011C00000010000000000000011C1C100000110000C00001010100010000000000000C01C000000000000000100C01
100000100000000000000000000C0100000011000100000000101110010000110000100000C100010100010001000001C001
1000000000000000010100000C101000000010000000C1000C00000100000001110100000010000010001100100000000001
10CC00000001010000C000000001001110000000001010000000000000010100010100C00000100000100110010C00011001
100C01C0000000010C00C01000010000000C0001000100000110000000C000000C0100000000100000110000100000100001
1001001000C0001001000110000000C0000000C00000000000001110000000100000100CCC0000010010000CC00001000001
10000000010000000001001CC10000C000000011000C00010000110000000100000000000000010C0001C100000100101111
100C000101010000010101C000000000100C0111C000CC1000100010C01111010010111010000100111001C0100C11C10101
10000011C000000000000001C00C100000100C01001000100001100000100C1000C101000010011001000000000010000011
10010C0000000010001000100000000010010000000001000001000000000C0010C0011100100000000C01000001C0001001
100010000001010100100C000000100000101010000000000100000100001100C10000100000011000001000000001100011
101100101010011C010000000000100C00100000001100100000000001C000000000C00000C0110C00110101100010001001
110C010000100000C100000000000001010C0101001001100100000100100000000001000100100000000000000000010001
1C1000000000010000001010101000011000000010000001000C00000C000010000001100000000C0000C100000000000001
1010C01000101000000CC0000100001100010000000000010100C00000000000100011001010000000000000000000000001
11C0010010001000000100000000101010CC00000000011000000C0011100010C010010C1100000000000000000000000101
101000C00101001C1C0000011100010000000C011000C000C0101110010001000000C0011000000010C00100C00100000011
1000100010000010000000001000000010000100100000000000001001010000010111100C01000101000000000000010C01
1000001000000000000000C00010C1000000100101000000000000000000010100000C001100000000000001000000010001
100000000C010000111001101C0001000010CCCC00000000C1100101000010010000000000000101000100000000000010C1
1010C1001000000100000010000000000C100000010000000000001001010000010000C10001C00110100010000010C00011
1101001100001000C01010000000010010C00000000010C000C01101C0010001000001001000000100C10100000000010001
1010C00000001001C10000000000010C00000C000100000C000000000C000000000111000C00001000100C00001C001C00C1
100000C00000011001001000000100000000000000000001000000000011000100000100000000000001010000011000C001
1000C10C00000C0100C1100000000001000100101100011010000000000000000001C0000010000100100001000C00000011
1100000000000000000000001C100001100000000000000000100100100000C00C0001000010100000C10001100000C0C101
1C0000000C0100CC0010001000C01010000010000C001010000000001100000100C000001100000000001001010100110001
10010000000011C00100010100010000000110100C00100C00000000001000000010C11001001001100000000100110C0001
1C0010C01001000100000001000001C00100000001110001000000C00010C10000000100010010C00C000000010010100001
10100000000000100010001000C0000100000001000000C01100000C010000C0000000010000000010110C00000110000001
10000000000010000000C0000000C11001001C000010010000100000100100CC01000000100C000000101000000000000C11
10000000000C000C00000000001001000010000101000100000000000101000010C00C001000000010100000001000C001C1
1111011C0001C000000C0000010000000C00C00000001000010001C000001000001000000010000000000000001000000101
1000000000001010000100000010001010101001110000000011000000010000000000001101000000001C01110000000001
110C00110101000100001000000000C001000C000000101101010C0001000100110000000100010001000000000C00010001
10000000100110100000001100000C0001000100000001C0001000000C00001C11101C1001000010000C0101000011000101
110011001000100000000001C000010C11000001100000000000000000C00001110001000000001C0000CC00000001000001
1000000010000000100001000000000000001000000000000000000000010001C1000000C0000000000000C0000110C00111
101100100100100100011000001000C0000CC000101000000010010C000010000000010010C01010000001C0001000000001
10000100010C01000000C000C0010100000C1100000010000C0000001000000110000000000000000000000C0C000C010001
101101C0011100000000101001011010CC00C000010011001C1001000000000000C001000000000100001010000000100001
1111000000010C001000010010000000001000001100000000010000CC010C0000C0000000000C00001000C0000000010001
1C00010000000000110011C0000000C000000001000010000010010101000000010100001010000000C01101010000001001
10100001C000010000000000001000010000000001011100000010000000000001100000000011C00010000C000110111101
10000000000000C0010000000C1000000000000011100100100000000C100000100001100000000000000001000000000001
11000000001110C0000000001C000010100100000000000001C1000000100001000010000000000C10C00100000000010101
1000C000C00100C0101011C00C100000000000000000100000000100000100000001000000000110000000000000010C1011
101000100000100000C1000001000100101000001100000000001100000000C10101100011000000010010000110000C1101
1C010001000C01000000C100100000000000000000C0C000000000010110010000000001000100010C010010000001100001
1100000C01010100101000001000010000C110100C0010000011000001010101000000000010000000000000011101011001
100100000C0000000100001000C0000100001010000110000101001000000000000000000100000000001110000000000101
10001000000000100C000000000010000000000000000110101010010000000100001010011000C10C11100C010000000101
10001100000000010000000000010010110000000C10C1001000000000000000010000101100000000001000100000010001
1C00010000000000100000C000010000100100000100C00000001C110011001000100C00001010CC01000100000000100111
101101010C000001C000001101000001C0010C000C00000C010000011000110000100000010100001000C000010C00000001
100000110100001100101010000001000001010000C000010010011000000010000010100000010010110110100000100011
1000C01010000001000000000000011010000100000000000000000000000C00000C0000000000000001000000C000010001
1100000000C00001000010000010100000000100C11C10000000010010010000000000100001100000000C01110001100001
100000010000010100001C0000C00001100011101000100C0000000C0010000C0001000100010C0000010000000100000011
10000000000000000000000010C01000000010000C00110C0010001000C00000000000000010010C01C00000101000000011
1000000000101001011010000000100010000000011000010001000001001100000100000100110001101110000000100001
1C1000100001001000000100100110001011000110001001000000001000001C1000010001000000000000100C0C00000011
11001000000000010010101100010000000C1C0101000010010C110000111000010010000000001000100000000101100001
10110000C000000000000000000101000010000000110000100101000000000010000110010100000000C001000C00010011
1100000000000000100010000000100000010100000000111000100001C11100000000000100000000000000000000C0C001
1000000000000100000C00010010000C11000011001C0000000110000C1C00000110110000000000011000100001000C1001
100001C01001100000010000000C0000C01100C000000C00011010000C000000000000C00000000100001C10000110100001
1C0000C10000000000110C0000011C1001010010001000100000000010000100000000100001000000000000001001100101
101100000100000000100000001C000000000000001100100000000000010000001001010000000000000100000C000000C1
100100C00000101010001101000000100000000C0C0010001000101100001100000C000000C001010000C101101001000101
1010010000C110000100100110000110000010101001000000001111100C0000001010001000001000000001101110000011
1000000000010010000011000000110000000C00000100000C01000010010000110100001C00010110010000010000000001
1000000000000100C000C001000010010010001C000000000000C001010000100100C0100000110100000010000000001001
10000000011000000001C0000000CC000C0100010000C001000000100000000000C0000000000100C0100010010001000001
10001C10000000010000100C1000001000000000000000100000C0C0000C1C00C00101000000100000C01CC1101010000001
1001000000000100100001C000000000100000011000100110C000001C000011000000110100000000001000000100000001
1000000000C01000001010C0100000100000000000000110010011100000C10C000000010000001001000000000000110001
10C00001000000100000C100000010C000001000010001010000000000000111C00011000110010001000010000000101111
1000000CC000CC00C10C010010010000C01100000000110C00000000000C0C1000001100000001CC000000000000C0100001
1C00000C0C1000010010000001100C010CC0110C000C000011100000000001100000000000C1001100000000011000000011
10010C01000100000000000001C0011C0C000000100010011001C00000000000100C00000000000000000000000010110C11
101000000100000E10C00C0001000110000110101100000C1C10100000001100000101101CC0000000000000000001C00001
1000000011000010C001000000010000001000100000000000010C0101000000C0C000100000P00010000010000C00100C01
10C00000000C0001000C01000011000000C00001010000000010100000001000C10000000000000000100000000010000001
1111111111111111111111111111111111111111111111111111111111111111111111111111111111111111111111111111