11111111111111111111111111111111111111111111111111
10010100111001000010110000001000000000000000011011
100010010C0010000000010000101000000C1000001C000001
11010100000001010000001C00000000010010010100001101
10100000000001000000C00000001000000000000000000101
1101010C0000000001000010000011C0011000010001000001
1100C000C0000000000100000000000000000C000111000C11
10C10000000101010101000000000100010000C00000000011
100000000101100010010010C0010001C00010101000000101
101000C10000100100100000100100C0001011010000000001
10001010110000100000101001000000001000011001000101
1000000000000010000000000000000000000001100CC01111
100010C010000000CC100C000101000010000000100001C0C1
11001000C0000C000000011000000000001000010000000001
10000011000101000000000000C01010000C00100C01001101
1100ECC000000000000010000100C110010001000001010001
10010000100C0100C000000010000000010000110100010001
100CC010010C1001101000C00000C0001000100000C00CC101
10000000000000000000000000101C00100C00001000011001
11C000000101100C000000110000000000100C01CC000000P1
101100001001001000C0011010000010010C10011C10100001
1000010001100001111100C00C0001C0010100000101101001
10000000000C00010101000101001000000010010100000011
100C00001100000010000010000000000100110000010000C1
100000001001C01011001100001000010C00000000000C0C11
11000010000100001001C00000000000010C010000C1100001
110000000C000000000000000001010110C10010C000001001
100000000001C0010000111010010110CCC000000001010001
10100111000000C00000000010000110000000000C01111001
11111111111111111111111111111111111111111111111111