111111111111111111111111111111111111111111111111111111111111111111111111111111111111111111111111111111111111111111111111111111111111111111111111111111111111111111111111111111111111111111111111
100000000100000000001C00000C0010X0000000000000000000000000C000000000000000010000000000110000000000100000000000000000000000000000100000C000000000000010000011000000C000X0000000X00000C00100XX0101
110000000C0000000000C000000000C10C000000000C100CCC00000000010000010000000010X01000000000000000000000000C00100000000000000010000000001000000100000000000000000000000C00100001000000000000CX000101
10010000000000000000100000001000000000001000000000000C000000000000C000100C0001C0000000000110100000000C000000001000000000X00000000C10100000000C01010000010000010000000000C0000000000000000000X001
10100C00X00C00000000C01000000001C0000000001X00010000100000000000000000100100000001000000100000000000000C0000X1000C00000C00000000000000000000000000000000000C0000000000000000000000000001X0000C01
100C01000000X00000C00XXC00100000100000000010001C1C000C000000C00C00000000000X0C1011001010X000C101C000000000C0C00000000C000000000000000000000010010010C0100001C00100100000000001000000010000000001
1000000CC000000000C00000000000000000000000000C0001000C000100000C00000000000010000010000XC0000000000000000000C000C000000100001000000001010100C0000C0000001000100000000000010000010100C00000000001
1000X000000001010000101100000010011000C0100000000000000C001000X0X00000000001000001010000001000000100000000000001000X0000000000000C000100C000C1000001000000C100C000XX0001C000000000101C0000C00001
1001C1000100110CX000001000C10000000000000000000000100000001000C010001001001000000010000000000C100000000000000100110000X00001X0000000000C1C000C00010000X100C0X00000100000C00010000000000000000001
100000000000000001100C010000C000100000000000100001000000100000X00X0000000010000XX00000000000000001000X0001000000C11000C00C0000000100C100000000110C10100001C000000000010101C0X0000000000000000001
1001100C1000100000000C0000001C0000X0000100X00000000100000C00000000010C00C0000000010000000000000010000X000001X00000000C0000000000000000000001000000000000001000CC0C0000000C000000001X0000000X0011
1000000000000000000000001000000000000X001000000000000C00000X0100000001000C1000000000100010000000001010000100010000000000000000000000010000010C001C0110000010000000000000C000C0000000000000000001
100010100000000000101X0000000000C0000C000000000C100001000000X000000001X1000C0101000000000010000000C00000000000000000000110000000010000000001C0000000000100000010000000C00C0000100000000000000101
1000000000000000000010000100000100000X000C0000C0000000100001010000000X000000000000000X0000000CC1C10001000C10000C000000000C0000C0000000000C000011000100100100000001000010000001000000000X00000001
1000000000000000100000001010100CC0000000100000000000C0000000000000000000000C000011CC00000111000X01000000C000000001000000000000000000000000C00000100001000C0X000X00C000000000100C0000000000X00001
10000000000C0010100100000000000000100000000000C0001000000000000000C00000000000000000000000000000000000001100000000000010000010000000000C00100010010010000010000000000000000000000101000000000001
1000000010000010001000000000100001000100000000000000000000100X00000XX0000C0001000000001000000000C00000000000000000001100000000100C00100011010000000100000000X10000000000X000000001000X0000000001
1100000C000001000000001000CC00000CX00000100000000000000000C0000000000000000000C00C00C100001000000100000000000C0C0000C000010C0000C000C00C0000CC00000000000C0000C0000100000000C00C00X00000C0X00C11
10000X0000000CC0000000000000000000010C000X0C0110C000C000000001011000000001000000X0000CX0010000000000000C00000C000000000000100000C0110000000C0CX000001000000C000000010000000000000000000000000011
100C01000000000000000100000000000000C100000000010000C000000X1000000X0C01000000000000000000000000000000000C0001010000000000C0000101C0000000000000000100100000000000000000000010011001011000000C01
10000100000C00000000000C100000000001010CX0000X000000000100C1100000000000000000010101000000C0X00000100C0C0001X0000000000000000X11X010000X001C00000000000000000000000000C0000000C00000001XX0X0X001
10C10000010000010100001000010000000100XC000000010110010C0010000010000000C10000000000100C00100000100C0000000000000000000C000000000010000000000000000000000X000C1000100000001000000000000000000001
100000001000C00000000100100011000000100000X110010001C00000000000000000000001C00000000000010100000000001001000000C0000000000000C01010100010C00000000000010000000000100100000001000000000000100001
1C0000001000000000000000011000C00000100000C00C10010000000C1010000C00000C10000000000C000010101X00100001000010011010000000CC1000000000100000000000000000000001000000000000000000000C00001000000001
1000100010000000000010C00000011C00000000001000000001C0100000000011C01001000000000000100110C000000000C00000001000C0C000000001000000000000000000C100000C0C100000100X0000000000C00X00000010000000C1
1C01C000000C00000C000000001CC0C000000100000000001000C0C0000000001000C0000100001100C000110000000000000100000000000000C10000000C00110000000000010010C01000000001000000000000100010000000C00C000001
100000X0C00000X00001010000000000000X0C000000001000000000000100000000000000000000000000000000000000000000010000000010000C01100001000C001010C0000000001C000000C000000X00000000000C000C000100101001
1010000000001000CC000000C001000000100000000000000000C00000000001000C01000001000C0010C0000000010C0000000X110X000000000000010000001000001001X100000000100100X000000000X0000000C000C000000000000001
10C01000000010CC001000001000000000C00000XX0000001000000100000100000000000000100010110000000000000000001001C0000010C0C00000000000000X0C0000C00000C0000000000C000001001C00000010010000C00001000X01
11C000100000000C0X00000100001000000000000001X0000010000000100000000000C100100000000000010110000C110000X0000010C00000000000000C000001000C000000000001000X00000100100C00000000C0000000000000000011
1000000C001C0100C0000000000010000C0000000000000C0000000100001010000100000010000000C1000101100001000C000011001000000000000001000000100000000000000000001000C0CC000000000100000000000100100X000001
1000000C10011000000000C0000000000X00000010001000001100CX0010C0000000001000000C0100000C000000000100101100001000000000C00000000000000000000000000000000110000100000C000000000000100X00000000100001
10C0001000000X00100000000110000C000000001C000000000000001X00C0000000101000000C010X00000C00C100000000000000001000000000000000100100001000X0000100000C0000000000000000000000X0000C00000X0X0C000001
10000100000000000000C000C00000101000CX000000000000000000000000000000000010000000000000000000000000000000001000000C00000000000000000X00000X00010000000000010000000000C0000C00C00000000000000000C1
100000000000000000010C000000000001010000C010C00000000C01001000100010CC0000000000001000100X000100000010101000000000000100100000000100000001000101001001CC00C0000000000000C000000X00000C1000010001
10X000000000000X00X00100000000100000110000000010100000000C0XX001000000C000000000010000C00110000000000100000000000000100000000000000000X0C00001000000000C00010000100000000000010000000000000001X1
10000000000000000000010010001X000X000000000000C0000001000C000000C00000000000001C0000000000010X000X000000010000100000000000000100000000C0001000001101000000000000000000C010000000X000C00000000001
100X00000000000C00000C0010000000000C000000000000000000000010000000000000000001000010100C00100001C0C00001C00C000000000100000000000000000000000010000011100010000000000001000000000010100000000001
1000C00CC01100010010C1000000000000000000C00C000C000000000C00C000000C00000000011C00001000000000C0000000000010000C1001000000000000C000000000000000000C11011000100001000000000000000001000100000001
100000000000C000C000000000000C1000000000000000000000C1100001C00C0C000000000000C01000C00000011C01000001000000C000000001100000000000000000C000001C001100C10000001000100000000C10000000000C00000001
1C0000000001000C00000000X0000000000000000001000001100C101101C00100X0C0000000000000010C00000000000100010001000000000000001X0X000C000010X0000100011X1000000000XC00000000C00000C000C000000000000001
1CX0C100C000CP0100000000000000C00001010010000000000000000000010CC000100C0000000010000000C100C00000000000000000000001000X100C000100001000000000100000000000000001000000000000000C0100010C00000001
10X1001000001000000000000010000C00010C000000000000100000C00000000010X0010000X00001010000000C000000100C00000000100000X0000001000000000C001010000100CC0CC000000000C0000000010000000000000000000101
110000C0101C10110X00000000000000C00000C000000C000101C0000001X00000X01X000100000000000100000100100010010000000000100100000010100100000000000X10C00010000C1001C0000000000000000C000001001010000101
100C0C00000010X00X000000100C0000C0C0100100000010100010000001000X001000000100000000001000000000010010000C01000000000000000000X000C0000000000000000000000000000000000C0000000C00100000010010000C01
10000000000X000100000000CC011000100000000100000000010000000100000000000000000000000C000000000000C0100000000000000010000000001000X00000C000X000000010001000000C1000000000000001000000010000000001
100000X0000000X00000000000000000010000000001C000X10000000000000C00000001000000011000C00000000C0000C0000000000000000C101010C0000010000110000000000000010000000000000000010000010100000000100C0C01
100C000000000000000X0X000C100000C00C000000100000010000XX000C00X000000C0000X000000000000010001000C000C000100C000000000100110010010000000X001001000000000000000000000000010C0000010001000000C01001
10000000000000C0XX0000000000000000000000001C0000C00100000000000000000000XC000C00CX000001100C00000000000C010000000000000C0000000100000000C0000000C00000000000000000000000000000X011C110C000000011
101100000C000000C0000000100010000100000000100000001010XC000001100000000001C00X00000001000001000C0000000000000X000000000000000100000000000000000000001011000X0000000000X0000000X10000010000000001
10001X00X0100000000000000001000000011100000000000000000C0X0000000000000110001010000000000000001010100000X00100C0000C0110000X000000000000100100100000100000000C00000101C0C10000000000001000000001
10010000000001000000000C0000000000000000000000000000000001C000X000000010100C00X00000C0000010000011000C1000010000000C01X00010000C0C000000000C0000000000111000000000C000CC1000100101100001000C0001
1001000010011000C000C10000000C000000C01000001C00C000000010XC00C100010000010X000X00000000000010000000C00X0000000100000000000000000000010101000C00000000000000000C00000000C00000000000100100000001
100000000000011C000000100000000000000000000000100000000X0100000X000000000000000000000000000000000010000000000100C000111000000000000010000110000C000000000000001000000001000001010000000000000101
10100000000000X0001000000C0000000100C10C000000C0C0010010C010C010000000101000C010CC00000010000000100001010000000000000000X0000C00C0100010100000000010100X010000XC01C000000000000C0000000000000001
11X000000000100000X000C00000000C0000C00100000000000000000C000C000000000000000C0000000000000001000000000000000X0001000010000000000000C00000C0C0000100000100000001X00000000001C000000C000001000001
1100C0000000100000000100000010100C0100000101000000C010C0000000000000001000000001000100000010000000001C00000000X0100000000000C010000000010000CC0000100000000000000000X000010000000010010000001101
10001000000000000000000X000000000000000000010C000000010000001100000000010001100000010C1000000C00001X000000100X000000000000000000000C000100100C000100100000000000000001000010100000000C0100001001
1000000000000100C000000000X000000000001001001000000C0000000100000X00000110101X00X00110000100000000000010000000000000000000000000000C00001100000000C001010100000000000000001000X00000001C00000101
10000000000100000000000000100000000000000000000C0X0C01000000CC10000000010000000000000000000X000000000010000000X00000000101010000001000000000000010000000010010001000C100000000X0000C000000X00001
10100C1C0000C01000000CC0000X0000100000011000000000000C0000000100000001000110000X00000000000000000001000000000000C0000000100001001000000000C00000000001010X0000X1000100000C1100000000100X00000001
1000000C000001000100000000C10CC000X001000000C000000000000X00010100C0000000000000000000C00000010000X00000000010010X0000001011000000010100C00000CX0000000C000010000C00C1000010000X0000000X00010001
10100000X0000000000000000C00000010010100000000000000000000100000010000000000000000000000100000000000001001000000C00000000000010C0000X00000100000000010000010000000010000000000010000000010000001
1000000C1000000000100000000C000010000000000100000010000C00000000000000000100000000000000000C00001000000100X0X00001010000000000000C00X000100000000000000010000000C0000100000001C0000000C100000011
100C000000C0C0000000000000000C0000000X00X000001000000000C000000000C00000100001000000000C0X0000000000000000000010010000101C0C0000C00000000C0C010000010000000000C0010X0000000010000000000000001001
10000C0000000C0100C000C000000000C0000C00100100000001000000001010XC00CXC000000000010010C1010000000000CX0001011011000000100000000001000C00000000000000X01010000010001000000C01000000000C0000000001
100000110C0000X000000000C00000000000000C000000000000000C00C0000000000000110000000000010000C000000000C1C10000000000000000010010000000000000001000100000000000100001000000000000000000CC000000C0C1
1000001001000000000000000000C000000X000000010000001000000000000000000001C000000100100000000000C00000X01X00001000000000000C000000X101000000010C000010010C0000000000000000001000X00010000100000101
1001000000C000000C1000CX0X0010X00C000001010C00010000010000100000001000X00000C100000000001100C01010110X000000000C1000000C001000000000000000000000000000100000000000000001000000010011000X00100001
1000C00000000000000100X00100000C0000100010X01000C0100010110C100000000000C01101000000000100000C00010110000001010000100C00001000101000C00001C001C1C000C000000000000110011000010010100100000001C011
1000C000C10000000000010011001000000100000X0000000010000X0000000010010010C00X000000000C100000000000X00C00000000000000000000000000010001000000X000000000000000001000000100000100000010C00000000001
10000000000000000000000010011000100000100000100X01000001000001X00000000001100100000001010000000101C0011000000000000C10000000010000C001001000000000000100000000000000000110000000C010000000000001
1000C0000000000000000000000000000000000010000000000100C0000C0000000000000000X0000000C1C00X0C10C0X000000000000000000000000000000000000000000CCC0000000010000000C01C000001010000010000000000000X11
100000000000000000000000000001000000C0C00C000000010000001000000000X0000000X100000001000000000000000X0001CC01000000000100000000000000010C0C0000000000000100000010CX0000000X00CC00C000100000100001
110C0000000C011000010000000000100C0000000000X0000C0000100000000000001000C00000X00000C01000010011000000000010100000000000X00100000000001000000C000000000000000000000100CCX0001CX010000C0111000001
100001000100X0000000000C0X00000000000000000C0C000000000000000000000000000000X000000000000100100100010000000000100000C010100000000000X001001000010C00C00C0010010000001000C0000000000C000001000001
10C00000000001001000X00001X0000000011XC000000000000X0000100000000000000C01000000XX00011C000100000000001000C000C0000001000010000000000010010000000010100010100000C0011000110000100000000000CC0001
1000010000010000000000000000XC00000X00110000000000110000000000000X00000000000000000010000000000000100100001001000000000000000000000011000000000C0101000000000001X0C0000C00000X00C100011C00X00011
1001010C00C00C0C000000000X1C11100000C00CCCC110100000000010XC00001X100100010000000000C00100100000100000000000000000X00X000100000000000010000001000000100100100000000101X00X000000000000000000C001
11000000000000C0000000010000C00100010000000000000110000110000000CX0000000000000000C00010000010000000000000001C000001010C000000000X0000000000C0C0001000000110010C0000C100000000000000000000010001
1000010101000001000X1000000000X00010000000000001C100001C00010000000000011000000000000000000000000000X0C0001000000010100000000000000001000000000000000100000101000000CC01000000000000001000000001
11000C00000000000000C000C00100100000110010C00000001000C00000C000C01100000000000010000000000000000000000C000000000100000000000CX00000000000100100CC00100100C0000000000000000000101000000000000001
1001001000000000000000000000000000C00000000000000100C000001000000000100000001100010010011C1C0000C000000001000C0000001000000101000X00100000100C00001000X0000100000000000000000C0000000100000000X1
10000000000100000000000C00100000000CC10000C0000000000010010000C0000000C0C00010C001010000100000000X000000000000000001000C0000C00110000C0000000000000000000X0C000001000C0C0CC000000C00000000000011
1000000000000C0C0000C0010001000000000010000010000000000000000C00000000C0000000010X00011000000000000000000CC01000000000001001000C00101000000C00000110X0000100000000001C000000101C00000000C0011101
100C00000000000C00000000000000000010000000C00000000C00000000000000000000000000010X00X00100100C0000000010C000001000C00000000C0C100010C0C000000010100010010C000C0C0C0000100C00000001X000X110010C01
1000000000010100X10000XX010000000000000000000000100000010000010100000X00C0000000000C00C0000111C0000100000C00000000000C000000000100000100010000000C0010001001000000100000000001000000000010010011
10100000C00C00001000000C00001000000000CCC010000000100000000C000000000000X0000010000000000010000X0000001000000000000000001000000010C0010000C001C00X00000C00000100000010C00100001001001000000X1001
1000100000000000000100000000000000C0000C0000000000C00000001C000C00000000101C000C000000100C000000000000000000C000001000000000001C0000000000X000000000000000C0001000000010C0C000000000000000X00001
101001100000000000100001000000000010C000000000000000100000000010000C00100000000C00000C00101000000X000000000C1000000C0XC00X0100000000000000X10000C1001000000X000000000C00000000000000000000000001
1001000000000C0000000000X0000X0000000000000X010010100X0000000000000000000000100001000X000000CC1010100C000000C0X000000000000000000010000100000C00100C0000000000000000000000001100001C0C0000X00001
10000C0001001000000000000000100C0010100000010000010000000100000X00X1000000010000000000000C00100000011000000C0C00100000C010000C0C0000C1000000X010C10XX0X0000C00000000001000010C0000000000110C00X1
10000C00C0000000000000X000000000000001000000000C001000000000000000100100000000000C0010000X00000010C0000000100000XC0000000CX00000X100C10000000X0000000000001C00CC100001100000101C0001000XCX100001
1001000000100000000100011X000010110001010001C0000000001000000C00000000000C0C11000X10001C000000000000C0000000000000000000000000000000000C00000000010001000000000000110000000000000100X00101010001
10100100000C000C00100000001C0C0C0000000000110010000C0000000000X100010000000001000000C000000000000010000000000000000CX11C00010100000000X00000000000000000000C0010C010X0100000000100000C0000100011
111000000000000000X0000001C0000000000000000000000000X000000C000000000000000X1001000000010001000000000000000010C0C00000X0C00001000000000000000C0000C000000000X000001001000000000000C0000001C00C01
1000000000C000000000100001010X10000101000000000C000X000000000000000010000000000000E00000000C0000000CC0000000C1001010000010100100000000011000000000010100C00000010000C00101000CC00000000000000001
10000C000C0X0000000000000X00000001001101011000000001000000C000C101100000000000000000000000X00C001000000000000000000100C00X1000X000C0000000000000000000100000000000001000000111001011010000000011
110000010000000001CC00C0CC00XX0C1000000010100000101XC00000000000000000001C00000001000C0000000000000000000000000000000000000000C0000000000X1000000000000000000000000000000C0000000000000000000001
100000100000100X000000000000000X00000100100X0000C0C000000010000000C100000X1C00000110000010000001000001100000101000000000000C01X0000C000000000000001X000000000C000000010X000010101001000000000001
1000100C0000000000C000000000CX0100000001000000000000000000X10C00000000000000000000000000010000C010001C11000000X00001000C0000000000000000C01X1000C1000000000000100C0101C00000100X0000001000100001
10C00000000000C000000000100C0001000000000C010000X0011001C000C0C101001100010110000000000000X0000000000000001101000C00000C0000X0000000000000000000010000110X0000000C00C000000000000010000000000101
1000X000CC010000000000110000000000010C10000C1000000000101000010001000001010000000000000000001000000C000C00000000000C0C01X0C0010100110C000000000C00C00000000C000000000C00100010100000000100000001
1010000000010100000010100001000000000000000001000010010000100001000C1000000110000000000000000000100C00000000000000001C000000000000000000000001000000000001000000X0000X0C00000000X000000000000101
1010000000000X00100100111C1000C000010000000X00100000001000000000000000000000000CC001C1X00000000000000000010X0C00000000100000000000000000000X0000000000000X0X001001100X0100000000100001000C001101
101000X10000X011C10000X100000000000010010000000000000000000000000000C100011000000001001X1C00000000110000001000000010000000000000000000010000X000000100C00000000000000100001000C00010010100000001
100000000000000000C000000100000C0C000000000000000C010000001000000CX000000001000100100000000000C00CC000000000000X011000000000000000001C0000000X111000000001000000001C1101000000X00000001001C10001
1100000000000000000010000000000000100000000000000000010011X0000X0C0000C001000000100100000C10000000000001000000C0000XC00C01000001000000000C010000000000000000000000000000001000100000000100000001
100CX00000010000100010000C00X0000000000010000C01000C0000000000100000100010000000X00010C0000001000000100C000C001000000C0001001000C110000000X0100010000000000000100C000000100000000000100111000001
111111111111111111111111111111111111111111111111111111111111111111111111111111111111111111111111111111111111111111111111111111111111111111111111111111111111111111111111111111111111111111111111