11111111111111111111
1000010C00010000CC01
100100C010000C000101
1000010X00P000000001
1100000EC100001X1001
10001000011000000001
1000000X0C00X0101001
1P10C0001C0100010001
100000000000000010C1
11111111111111111111