11111111111111111111
100C10X0000C100E0001
11000000000C00C00001
101CX00CE01001000101
1010X000001000000101
1X001000CC0000001001
1000C000P1C001000101
10000000000000001001
10000000001001000001
11111111111111111111