111111111111111111111111111111
10000100000C000010010001010001
1000001000000000C00100X0001111
101100C10000101000100101001001
100100000000C000101C001C001001
100000000000001000001000001PC1
1000010C100100C000000100C00001
100000000001101101000100C00101
1001100100CC000010010000010011
100101001000C001C00100000C0011
1010100000C00011000001C0000001
100100001000000000000000100101
1100010000X0000011110010C01101
10010000100001000C000000000001
100010101001010001101001000001
111C011000110C00110000100C1C01
10101000000100011010100100C001
110000010000011000000010C00001
100011000CC01000000100101C00C1
1000000001C0000010010100000011
1C0000110000001100C00000010101
1011100000001100E00000000C1001
100011010000000010000000000001
100010000C10C0000000010C000001
111111111111111111111111111111