1111111111111111111111111
1100C00000011110CX1000001
101010C0011000010000000C1
1000000000010110010010001
10X0001010100000000000001
1000010100010010000010001
10001000100010000C11P0001
10000101101C100CC00010001
110000101000000000001C001
10C0000001000001100100001
1C00X1011CCXX1000010100E1
1C10111C0101010000X000001
1010000010X00C10010100101
1000C011000000C1000001101
1111111111111111111111111