11111111111111111111
100X0C10000010000001
1000CP01000C0X000001
101100000X0C000X0001
11C0010000000E0000C1
10000100011000010001
10000000101001000101
10000000C10000000001
10C00001001C0000C011
11111111111111111111