11111111111111111111111111111111111111111111111111111111111111111111111111111111
10010C1001000X1X1000000000000000C00000000100101000000010000000000001000110000001
100000X0000000000001C001100000000000000000000C0000000000000000101001010000000001
1000100000100000000000000000000000C0000000000000011000000000000011X1011000000101
10000000X00010000000000C0000000X00011000000011C000C10000C00000001000001000100001
10100000000000C000000C0C011000000100000000000000110101000C000X000001010000000001
10000010000C00010001000100000000100000000000C0C000000000000000C00000100000001011
110000X000000000C000C0000000000X0000100000001010X0000100000C0000000000C0X0000001
1000000000000000000000000000000C000000000000000010000000C0000000000C00000000C1C1
100101000C0000000010C0C00000000X001000000000000000C00000000000000000C00001C00001
1000001000CC00100000000100C00000000000011000000000001000000100010000C000000000C1
100000000C0011C001C0000000000100100000100000C0000010C0000100X000000000000000C111
100000000000100CX0000010000000X01000100000000101000C0000000001000000000000000001
10000000000000000000000C00000000000000000C00001010000000000000000100000000001C01
100000000000C01X0000000001100X00010C00C00000C000000000000000000C001C001000010011
1011000000000000000C000000000000000001100100011000100C00000010C010110C00C10XX001
11000000000000000000000000010001X11000100000001000000000010000000001X00000000001
1000010C00000010000000C000000000010C000101C0000000CX0000100010000010010000X00001
10000000000C10X0C00000000000000000000001000X1000000000X00000001000X0X00100000011
1000000C1000010000C0001001000000000000000X00001C00000000100010000000000000000011
1000000000CC110X0000100000000000010001000C1000100000000000100000000000X00000C001
1011000100000100000000X00000000000C00000CC0000000000000C00000000000XX00C0000C001
10X000001000C0100001000X000000000000000C000000000000100C0001CX000C0C010000000001
10001000000000100000100C00000010000010C01010000100000001000000C0000001000X000001
1100000001000000C0CC0X0000001XC100C00100C0000C0010001110X00000000000000000100C01
100100010001000C00000100XC0000000001100000XX000000001C00000001000000100000100001
100C000000C00010000000000000001000001010001100C01000111000001001C01000000000C0C1
10000C000100000C1000C010010000X000C100000000000000100000010000000000000C00110101
10010000000000000000000000000110C0000000000001000000X000010000XC1010000000000001
100000000010X000000000000000000000000000C000000100000X1000000010000X0100000010C1
110C10000X0000000010011000000110C000000000000000000000X0000000000010110000000001
1X000C01001000C00000000000000000110E10100000100100C00000000000100100000000000001
10000000100000C0010000000100C000101101000000000C00000000000100000000010000000011
1C00100000C0C00010C0000C0C00C000C000C000000000000000C00000X000000000000100000001
10000000X0000000C000000000100000000000000000100X00000001000000000000C0C000000001
100C0011000000X000000X00X0000000X0001000000C0001000000C0000000000000000C00000001
110000CC01011C0000C00C00X1100000C00101C00C00000000000100010000000001X00000000001
100001000X00000X0C0000100000C000C0010000001010000000000010000100C01010C000000001
101000000000000C001000000C000100000000100000001CX00000000100000010011000010C0001
10000000X0010X0X0C0010000000X00001000000101000000000000001000C00000000100X100101
10001000100000C00000C00000C0101000000C000C000000001010C00000000000C0000000000001
10001000C0001000000000001000000C000010000000000000000001000000010010000000000001
100C010010C0X000000000000000000C000000000000100X0100000100000C0010X100C0000C0001
10011000010C00C000101010CC0000000000C000000000000C00100000000000X0100C00000000X1
1000010000X0000010000000000000110000000010000010000000000100000000C000000C0C0C01
10110000C01000100010000001000000X0000001000000100000000010010000000000C000000001
1000C00010000000C0001000000C10C110000C01000C000X100000010000100000000000C0C00001
100100000000000C000000C00C00C000000000000000000100000000000010000000C1001000X001
10001001000000000X00100001100X0010000000C10000X0000001000000000000000000000000C1
100100000000000CC000001C1000C000000000000000000001C0010000001010000000X100000001
1000000000000000000000X0000X000100000001000X100000100010000001000000001001000001
1000010001000C000000000000C0000000C00000000000100000000X0000100C01000000000000X1
1000000000CC110010000000010000000000X0000000000000010XC0010000000000000C00000001
1000100000000000C00000000X000000010X00000101000000000C00C0C1001C00000C0000000001
10000000001010000000001100C0000000000010000000010000000100000001001000000P000011
101000000000000C0000100100C00000100000001C000000000001C0C10000000000010000000001
11100000000000000C0000100X000C00000000101000000C0110000000100X001000100000001001
10C000000001000000000000000000100000C1000000100000000X00000000000000C00000000101
10CC00C1000001000X0000001001000000000000C0100000C0C0C00010C000000000000000010101
11111111111111111111111111111111111111111111111111111111111111111111111111111111