11111111111111111111111111111111111111111111111111
1000000000000C00000X00011011001000000000100100C001
10010000010010100000C011000010000010000C001C000101
100000100010CC0C000C000C0100000001000100C000001101
100100000100001100C0C011X00010101000000100X00C0001
10010000000000010000000X00100010100010EX00000001C1
1000C10001C00000001000X001XC00X100C000100001100001
100000000000X100100X10010000X0001011000111C1CC0001
10011100000100000010000100100101000000000C10101001
101010000100000000000000C001000000000000000X000001
110100110000C00C001000010100000000CC00CC0000011011
10101010000010000000X000000000000000100C100C001001
10001000001000100C100000010000000100000C00C000X011
100X1000010000000100C100101000000CC01001000C11X0C1
100000000000C0000C00100011001000000X00000C10010001
100100000X101000010100100101001X00001111C000000C01
100000000000C01C0101001000010000000010100001001001
100001X0C0C00100100C1000C1000100100011100CX1010011
10X0X010000000C01001000011011010010000000000000001
1001010P000100C00110010100C01100000000000000000001
100X000000111010000010C00000011000111000100011C001
1010000C0001001101000000001000X0100000000110000001
1100100C00001100000000000100001010C0C0000110001001
10010000100C0X10000110000000000000010001001C100001
101010111010100000011100100000CC0000101000100C0001
11000000000111C011000111000001100000000C00C0110111
10C11X0101101C01000C100000001010000010X00010001011
100C11000000000010000X1C00001000110001100000000101
100010001000001000000000000010X000C101000010110011
11111111111111111111111111111111111111111111111111