1111111111111111111111111
10000001C0000100C10C10001
10110001X0C0000011010X101
101C100000010X0000C000C01
1100010000X100000X0000001
10000000001010000011E0C01
10000000001110000010010C1
1000000001000000000110011
1110000000010101000001C11
101100100111100X010001011
111101X100000001001010001
10000C0P0000C000000CC0101
11001000010000C0110010011
1C000001C00000C1100010001
1111111111111111111111111