11111111
1X100101
11E01011
1C1C0P11
11111111