1111111111
10101010C1
111110EXC1
1110001011
1000000001
111000P001
1C00100C11
1111111111