111111111111111111111111111111
10000010X0101000100100C1010111
10000000010C01000110C000001001
1110100010000000000C0111100001
100000000110100011010000C00E01
1000000010000001010000C0000001
111C0000110010C001000X11110001
10001000000001X00X000000000001
100X01000X00000100000001000C01
1011C000000000C0100CXP00001001
1010000010000000000101001100C1
10000000010000000C001001000011
1011000000C0000C00000100000101
10X0000010100110000C010110CC01
1000100000010C0110X00100000001
100001C00110X0000001000101C111
1CC00010101000000000010X000C01
101C111001001C1010011C01000011
1000011010X00011110011C000C101
111111111111111111111111111111