111111111111111111111111111111
11100100000XXE0000000000100X01
100000110C00001010001100000011
10010001011000C000X000X0010001
11000C00100001100C1001C0000001
101000C0C000001X10000000000101
100011000010000100000000000011
100000000001000100001000X0C001
1C10000000C0000000000000010011
11000000X00000001010C0C0000X11
11C000001000000001C01000000001
101100000000100C0000P00000C0C1
1000100010C00001110000C0000011
110110000000011000001100010001
1111000100010000100C1C11000001
101001010101000000C1101000C001
100100C000C0101010011X100111C1
10100001C10100000C000C01001001
1001000101X10000C0011X11000001
111111111111111111111111111111