11111111111111111111
1C0000000C0000001P01
10000000001000000001
1010C10X0CC000001101
11000000000010000C01
100000000000010X1001
100000000C01001000E1
1C01001000001101C001
1C000000000X01X01011
11111111111111111111