11111111111111111111111111111111111
1010CC0000000C00C000000110010011001
10C0000100100010001P000100001001001
10C10110C00000010010001000C00100001
1011000X1000X0100X00000100110000001
1011001000000X0110X0000000000000001
1101000000000X000000001000C01C100C1
100000001X0001011000100011000010001
110000010000010000C00010110100100C1
101010000000000000C00110000XC001001
1100X0C001101111X000011C0C000000001
100000000101000001000E0C00001100001
1000C0C0C0001010100011100C000100C01
1011X00101CCC0100100000101000110C01
100C010000000X0000101100C0100X00001
10110000000C10100110001000000010001
1000001000000001000000C0CC000001001
10001C00100000000000000000010010011
1001010010010001000100X000000000101
11111111111111111111111111111111111