11111111111111111111
1100001000E000100001
1C1C0011C000P0000101
10000C000100C000CX01
1001000001C000000101
11000000000000000011
110X000X00000000X001
1000C000C00000C00011
10000000000100001001
11111111111111111111