11111111111111111111111111111111111
110C110001000000C0C000010000C001001
110C0100XC0C0C000101000001010010011
101010000000000001101100100110C0001
1CE0011100100C000110101000011000001
10010010001C00000001000000011100001
10X0110C1000000000000000000010XC011
10C1101000000C00001000001110C0XX001
100C010100101011000001000C0010000C1
100001000000C00010000100X0000000001
10001100C0110C000001010C0C000011001
10000010000101000000C010P0001100001
100X10000100010001000110000X0010001
100010000X001000101X101001100110101
11111111111111111111111111111111111