111111111111111
11000100010X001
100PC110100X001
11CCX0001000101
100100111000001
1010C10C0011001
11000C010000001
11011010100E101
10000100C000001
111111111111111