11111111111111111111111111111111111111111111111111111111111111111111111111111111111111111111111111111111111111111111111111111111111111111111111111111111111111111111111111111111111111111111111111111111
10010000X000000000000000000000000X00000C0C000000100000010000001100000000000000000011100000110010C000000000001000000001C001010000000010010000000100000001100C000C000000000000X0000000000000X000011XC0X001
10000010000000011000110000000X00C00000000000000000000X00001000000000C000C00000100000000100000000000000010C0000000000000000000000100001000010000000000000000000010000C000C0000000C00000X00000000100X01001
1010000000X01CC0000001000C000000000000010010010C01000C000010C1000C00000100001000000000000000C000010001000001000000000000000001100000000000000100000000001000001C000100000000000C000X0000C000010100100X01
1C00001101CC0010CC0000000001000001000010C1010CC00000000CC0000000110000X000110000010000100000000000100010000000000000C0000X00000001000000C0C0C0000010000000011000X00000000000000000C0100010000000C100C001
10000000XC000000000000000X000001000000100C000100C0000CC000C010000000C0001000000000000100001000C00000000C0C00001C0000000000000C000000C010000000000000000000C100100000000000000000001000000000000000000001
101000000000001000000C0C0000001000000000000000011100000000110001C0010000000C000000000000010110000000000000000000X0000100000100000X00000010000X00C00000X000000011000C1001000100001001000000000000010C0001
10000CC000100X000100C00C00001000001100000010010000100000000000000000C00C000110000000C0C0101000C00001100C0001C01001000000000000C10000100010CC00000000010X0000000100X0010100000000C00010100001000X0001CC01
10000001000001000C00000000000001XX00000C1100C00C000000000000000000000000000000100000000000000000000000C100000X00C00C000CC010000X0000C0000100000X0000000001CC00000X0C0000000000000001000000000000XC000001
101000000000001000C0001010001000001000000100000000X0X00000010000X00X00000000000C00000100XC000000000000100X000010000001000C100000110C00000010001000000100100010001000000C00000000X0000C1100000C0010010001
10C00000000000000000C010000000000000000100000000000000000000X00000000010000001000000000000100001000010001000000100000000001000000C00000000C10100X00000000000010C0000C00000000C000010000000C1C00010000111
100100000000010000010001000000C001000000000001000000010101000C000100000000C0000000C00X000001000X00000100000CC00100C00000000010C000010C00100000X10100X00000100000C000001010101C000000000000X00000X0C00001
100000000000000000001001000100C0000C10CC0010C000101000000000010000100C1C00000000X0X000010000100100000C0000C00010000000100000010010000000C000000010C0C001000C0010C1000C0000000000000C000000000001000X0001
100000X1C00000000000000000000001000000010000C0000000000100101000010C0000000000X00010000001000000001000000010000000000C0X00000010C000000100001C00001X10000100000100100000000000100000000000000000000000X1
10000C0C1C00001000000000X0000C0001000000000000000011000C0010000000010C00000101000000XC001X00C0000000C0000000C0000C0000000001000X000X00100C000000100C001C00000C0000100000100010C1010000110000100000000001
1001000000C00C0C000000000011X01000000C00000000010000000000000000000000000010000000C0100C00000010000000000000000100000100000011110000000000000000C01000000000000C0000000000C000010010C000000000C000000001
100000000C00000100000000000000101000000000000000000000000010010XCC0000100000010010000C01010010000000000X000C0000000000000000C000C0010000100X00000X010000000000C00000000000000000000C000000CC000C00000C01
101000000C10C00X01001C00000001000001C00000C000101X000X0C00100000C00000001000000000C0001000000001110000001000001C000001000C00C000000X000001C00000000100000C0000000X0000000000X100000001100C00000000000001
100100C000000000010000000C1000100000100000001000000000000000000000010100000000010000000100000001000000000000000100X00C010011000000X00000001CC0010C000C000000001000C000C00001CX000000010010C0100010000001
1X00P110001000100000C000100000000X000000100000000000000000C010001X000010000000C000010C1000010000010011010000001100000000000000000000000X1000000010000000C10000000X1000000000000001000100010000000C100001
10100000000000000001010000000C100000000000C0100C000000010011000000C00000C1C00000100000010000100100001000X00CC0100010000X000000C0001000000001C00000000000000100000000001C01000000010000000000C00100000001
10X0010C1X000C00000000000000000000C0000X0011000100000100000000000X00001000000000000000000000000010000000C0100000010000000010C000000100000000C000000C11C0000C0000000100000000000100010C000000000100000001
110000000010010000000000100001001C000000000010000000000000000100000C00100C000X010C00000000000100000C0C0000XX00110C00000000000101000C00000000000010X000000C0000000000010000000100000000000C00001000000111
1000000000100C0C00000C0010000001000000000000C00000000000000100000000000110000000100000000000000000100100000000C010X00000010X0001C00010X000000100000001000000C11000XC00X000000100C00001000000100000010001
1000000000001000000000000001000000X00X0000001010000001000000000000000000000010C000011001000000C000001000000000000C00000C000001000000XC0000010001000001000001000000011C0000C00001001000000000000000000001
10000100000100X000000000011000001001000000X000010000C00000000100001X010C0000010000000000000000000000000000000X0000X000000000000100000000000000000000000000000000C0000110000X0011001000000000010001C00001
100000C00000100000000010X01000X100000000100001000C00000000001CX010X000000101000000C000000001000000000000100C100000100000000100CC0000000000000010001C10C0000C0000000000000C0X01000001000C1100000000C01001
10C00000000001000000X00000010000000000101000000000000000000C000000C0000000000X000C0X00C01000000000000000000000C00000X0100C00010100C010C00000C00100000000000000000000000000X10100001100000000000000000001
1000100000000C000000000000010000000000X00C00X00000000000000000000000000010000000C000000000E000000001000000C0C0000001000C000000000100000000000000CCX0X00000010C0101100000X00001000000000X0000000000000011
11111111111111111111111111111111111111111111111111111111111111111111111111111111111111111111111111111111111111111111111111111111111111111111111111111111111111111111111111111111111111111111111111111111