1111111111111111111111111
11001C001C11000C000001001
10000100001X1000C0101CC01
1000C10001100C01001000X01
10001001100C00100001X0001
100000000001000100P000001
1000001011X00110C1C0000C1
1010E0X101011000100000011
10C0000000010010000001001
11100C000001100C0X0001011
1000000010000C01000011101
1010X0010110C110011001001
1000100C00000001000000011
1100111000001000000101011
1111111111111111111111111