111111111111111111111111111111111111111111111111111111111111
10001000C00011000C000C00100110000000001101101000101010010001
11101010000101000C101100C0000001001110C0001100000010100000C1
101011CC00101X0001000010100000000000010C0000001CX00000000001
100000100010010110100010000000000000101000C01X0C100000X00001
100X0000000110010C00C0011C0000011C1000C000100110000000000011
1000100000001000000110010000000001000001000100010C000C000101
1001100010000X000000C0001000011010100011010000000010C0001001
10100C001000C000C1000001100000001000C000100010010X0001010001
100000010001010000100C0000000000CC10100010100C00000000000001
11000X0C0001110001000000010001100000100100100001010000001111
1X000010000001100C01100010000C0C0010100X0X00100010X000CC0001
101000010010001000000100000000011C000010010C0001C0010000C001
100C1000000000000010001010001X010010010010C010100000001CC001
1000001000000000001X100C100001001100000100X101XC10C000010011
1100X0C000010000000000000000000C000010000000000000010010CC01
10101C100000000000X0000001000000010CC0101101CC1X011000000001
100100000100101100101100001010000000X0000C00C00000010XC010X1
1001100000010000001C0000100001X10001000000000000100C00011001
1000X1000011100000001C11000100100C0010001100111C000000100011
1110000CC010000010000X001010100000X010000011P011110010000011
1000001010000101011000000C1001000000010000010000100000000011
11000000010000010001000CC000C00010000000011100000C000C10X001
101100001000C0010000000100000110C00100000X001000000000000101
1100000CXX00000000C000000C100110000110XC0000001010010000X001
1C0000000001X01100C101001101000C0010100100001000000000000001
1000101001E0000X0000000100000000000100100000100000000C100001
1000X01011100001110000000000000011010100110000000C0000C0X111
100000010000000010C0C001010000001000X10001011000000000000111
100000011100000001X010010C1010010001011001000000000000010101
10C1000000000000000000010100000X00110000010C001010CC00000C11
100000001C000000000010100100010000C0110001001010001010000001
10C00111001000000C0101000C0101011000010000000001001100000001
10010000010000010010001000001000010010010000001000000XC00001
1XC0000000000C1101X000000C0000000C0C01000010000000C000001001
10C00000010000010010000100000001000100000100000011X000000001
10000011001100001101XC01110CC0X000000010C000000000X000010001
1C0000000001001C0000000000000001X0C0C0010101100C000001100101
10CC100X0000010C0000010C0000000010000000001001100C000C011001
111111111111111111111111111111111111111111111111111111111111