11111111111111111111111111111111
1100C0P00011000000000C0000011001
100C010C00C00X0E000X0000100C0011
11111111111111111111111111111111