111111111111111111111111111111
1000000100100C010001001000C001
11X001000100X01010011001X00101
111P000C0000000000000C11010001
1000010001001000101110010000C1
1001000010110000C1110C0X000101
10000C0C010000000X000010100011
100X000101100101000000C0000001
110001010C010C0C10C00000100C01
100000100000X0001000010X0C0101
1010101000000000000CC10000C101
100100000101000100C000000C1001
11000101011000010000000C001101
111000000001100EX0100001000001
111111111111111111111111111111