1111111111111111111111111111111111111111
1010000000001000C000100110X0010000000101
10010X010100000000E00010000X011001C00011
1C0000000C01C00100110100000X010001X10001
1000001000000011000C00000010C1C010010001
11000C0001010000111C0100000C000110000101
1X00000000010000111100010100000101000001
10000010C01000101C0000100C10000100000101
10001010C0X0X0010X00110100001000C0X00101
10000000001010000000000000010C0000C10011
10010XC000010110001010C00100010000110011
10C00000001000100001100110101110X1X00001
1100000001000001000001001000001000X00011
11000X00000100C00001100XC101110010110C01
10C011100111001C0C1101000000111000000001
1000100C001100000000000C1000010000000001
10001X000101C000000000000100101000000011
10000C000000000001001C0000100P0010000101
10001100001C0C0001001C100000000100100001
10C0X000000C0100000001000C001C1011000001
1000000000100000100000000000000000X10001
100100100101000000010C00C001100100010X01
1000100C000101C0001000000100000C000001C1
100000000000000C00001C1001100000000CC001
10001000000C0000010000010001X00C01000001
111C000000101000010100C00X000000C0000011
10110100000001000000001000001C1001000001
1C0100000000C01001010000111001C100001101
1100X001000000010X100C00010000000C000001
1111111111111111111111111111111111111111