111111111111111111111111111111111111111111111111111111111111
10000000000100000000X0000000101000C0000C01C000000000C0010001
1X01001001X0000X0CC00000011000000010000X00100000C01000X00011
100C00000000000100000000C0C000000010000C00X0C00C001000XC0C01
100000000C00010000100000000110000010C1010000100000110C00C001
100000000000000100000100010001000E000C0000000000000000000001
1C0000000101100CCC00000100000C000000C00C00100010000000000101
1000010000000100X00000000C10101C00C00000000000X01C000C000001
10000000000C0C100C00100000000C000000000000010000010000100011
1000C000010000001000XC000100000000000100000000100000000C10C1
10C00000100010C1001000000000000000000100000000X0001000000001
1000X000000C0000000000000000001000000X0C00100000000100000001
1000000010000000100000000000C000000000000000000000000100X101
10C0C000X0010000000010000000000000C0XX0000000000010X00000001
10000X0001000X001C000100C00011100000000000C00010001000000001
100101000000100C00000000000000000000000001000001001000000001
1000000000001000000000001000000000011100001000X1000000001001
10000010C00000C00000001000000000000000000000001X0000CC000001
10110X010000000001000000001C00C00000000001000C00C00010010001
10000000C00000000000C00000000C0C00000010X0000000000C00000101
10C0010000000000100000X00C000000000100000100001010000C010001
100000000000000000000000010000000000000000000000001000010001
100010000000000010C000000000100010101001X00010010000C0000101
10000000C000010C00100010010000X00P00010X00011000000C00000011
10101C00X00C000000C00010X0000010101000000000010100001000X011
1C00000000001000C0010000X000000001000C0000010000000000000001
1000010000C001000010001000000000100000000000X00000X010000C01
100000011000000000010000100000000000000C00000100010000000C01
100C000001000000010001010X000000001001000000100X0010C0100011
110000000000000000000000001010000000000000000000010000C00101
100001100000010000000000000000010000000000000000000000100001
100000X0000000000010C00001000010011000001010000000000100C101
1001000100000C01C0000C0000X00C000001001001000C00000000C000X1
1010010000000C0000000000011000000000000000C000100000C0000001
10X000000001C0100X000CC00C000000010010000000C0001100000000C1
1000000000001C010000000000C0000100111CC0XX00000C0000C0000001
10000000X000000000010100000C000000100C00000X0XCC000000000001
1X0010100000000000000000111001C000000010000C00C0000C10001001
10100001000000C0010000010000000000010000000000000010000C0C01
111111111111111111111111111111111111111111111111111111111111