1111111111111111111111111111111111111111111111111111111111111111111111111111111111111111111111111111
1C0000000000C0100010000010000001010X00000100000110C0000000010010000C010C010C100000001000100001101001
10010000000010X010001000000000000011000000000000011111110010C0100100C000110000011000000X000000000101
110000000000000001000000010010000000000000C0000100X00010C110000010X1001C10C0C0110000001C000010000011
1CC1000101000000000001000000010101101000001010010000100000000101001010010X00100001000000001000001001
1000010001110000001000000001000010000000000010000100000010100C0000010001110000100000001010000C000011
10000000000X100C0110X01100011CCX0000000010100000000000100C0001C1000100001101000X0001000000000CC000C1
100000000000000X0000101001111100000011010000000C00000C0000000000C0001000000000000C000100001101010001
101000C1011000C0101100100000100000101000C000011C01001XC000010000C10000000100000000000110000000000001
10000000C0010110001100000000110010010100C0C0100C0001001000000C0C0C111000C1X0100010000001010101001001
10010100100010000C100000000011000001C000010C10011000001000000100CC0000000110100C1000000100100C010001
1010001000C01011C10000100000000000010C010C0011101000100000110000000C00001010001010000000011000000101
11000100010000100000000000001010000100010000C0100100X100C0C0000000110C010010010001000C0000X000011011
1000C0000C01C00X0000110001001C00000C00000C00C11000100X0000000101000001001100011100000000010000000101
10000XC00000C000000001011000X01100000001011100100000001000000000001011100000100000001100100010000011
100C000001011000000100010000000000100C10100000010100000C00010001C0000001000C0010110000000001111110C1
100C00001000010001100000000110CC1001000000000010000000110000000C0010010C00001100100C0000001000000101
1000100100000000000001CC00000000C10000000000000010000010010000000100C0000001100101000100000C01001001
100111000X00000000001100001001000110C0100010000000000C110C0010000010X01001101101001000C0000100010CC1
100000010C1X00000000000110000111000100000000000010000100000000000000000001101100C00000C0000000000111
10000000000000000011000C010C010001010000111000000100000010C100000100010000010000011C00000000000C0C01
10000100000100000100001C00000100010000000000101C0000001010100100010000000C010000C000000001C100000001
100C11000001000010X00000000001C0000010001000010000010010010000000011000000C0C00000110010101011000111
10010C00X0XC00C110000000001C000000000000C000100C1001000C0C00C000000000001100000CX000XX0000C000000001
100000000000C001000000000001010C1100CX00C0C01010000100000100000C1000001010010X1000C00001100100000011
1000X00X0000011000C00011000000010010000100001100000100011C001011000100100X011000100101001110001C0001
1X00X1000100C000000000C00000100101010X000000010001010C0010000000100100000000000000000011000110000101
100X010C00000000000010000110000000010001001000000110000C01X01C010101100001000C00C0000C0100010100C001
100100011010000000000110001010C0C0001000000010100100000000000C00000010000C010X0100000000C11000010001
10000000100000100100100100001111000101001000000C0000000000100C00C101001010011100000000000000001001X1
1000000000100000110001000010000000000000000000000000000C00100000000000C0C00010000001000000000010XX01
10001000000101000010X0000000100000000100000C00000000001000100000001101000000010000001X01000000000011
100000100X00000110X01001001X0CC00C0000000001000000101100X11010000X100C0000000000000010X0100000C00001
10000000001000000000X0C0010001000P010X000010C00010010000000C001010100000C0100000100100010000CC010011
1011000000000C0001000000X11C001001001010000001011000110C00110C000011000010000X0001010000001000000001
1000000000001000C000C0000000010100100100000001100C000000000100010001100100X000010010X010000000C000C1
10C0010101C0000C000011C0010000110C000100101001C011001111C0100X100C10100010000000000000C0010001001111
110C1010000000000000100001100000000C000000C010000100X0100C001001100000010X100C0100100000000000010101
1010C01000101001000C0C01010011C0010000C0C000C0110100X0100100000C100X001C00000000000X00000C1110000C01
100010010C100000100110001001X0011000000000C0X0001000100100000C0100011100000010000CC0000X0110X00000C1
10110010100000010C10000010000C0001000000000C0C01C0001000000000000X0000010000C0000011C001000100000X01
10100001001010101110010C1000111001000000001001001000100000000000010010000000100010001000100000100001
100C000C10011010010101000000010000000C000X0000000000100CC00010000100X00C00010100C1010000X01X00000001
1100100001C10100C000CC0C00000001010C1000C011001000010101100001010C01100CX0C00001000010011110100C00C1
10000000000000010100100C001001010010000011C0000000000X0000010000001010C100C10C01010000C00000C00C0001
100000000100C001000010000011100000000C0001000000000X0100C01000000100100010010000001000C0110000000101
1000000X01000X0100000000010001000110000010C0011011000010010C010000100000000001C00100101X000000000001
1010101C0010000010000010010000000010100001000000110000X000000000000100100010000C01X10110000C10000001
1001000000000000100000000101100000X000C00000000111000010101C1101CC1C0010000000001010000000C0001C0001
11001000X0000000000X000000000000001000010000000010010000010C1X0101000100011000000010100C001000000101
1000XC1000001000000000C0100011110000C00001001110C00000X00001000100001010000000000000C00000X001001001
110C00101X0010000010010000000000C0000000000001000100010000100000100010001100000100010C00C100100XC101
11010000100000101000000C10101C0100000010010001000X0000001000001C00X00001000100100000000101001X000001
10100000000001001000100X00001001000001001C00000000011C0000X0000000000C110000000000000010000000100001
1010C0X0C001C00X0000C1000100100X000000100C101000CC00100000000001000010000100000001000100000000000001
1100001000001011000000100100000XC01000000101000101010C001000X0000100000100000C1100000000C0110C100001
1000010000100C0C00000010000000010000000001000011000000C100100101000000001000000100C100CC0X001000C101
100000000000000000001C0100100X1000001001000100010001101C00110000010010000001001000000100010100000001
100011110100000001000C0101000000100000C00000011100010010001X010000C0X0000C0000000000C000100000000001
110000010010000010100010000001X00010001000100100C0000000111000011X010000100C1C0001001C00000000000101
1000000000000000101000011C00000000X00100000111010000001000000001000010000000000000000010000011001C01
101000100000C00101XC0X00010000100000001101000101X0000000110000XX1000C0000000000000C000000000C0010001
1010X010010000000010000C000000100X0C00010101101C000000C100001000000000100000001000001001000100011101
10000001000000100010111000000000000010CC100001001100010001000000000100010110001100C101100010000C0001
1010101000000001100011000100010010000011C0101000000CC0010C100010011000C100X1000000000C0C000010000101
1C0001XXC1000101X0000011100X0X0000000100000001000100C0000000010X001100000101X00111000000000010001011
101X00X0010010001000100000001001100101001C0000110000000100010000000100010000000100000100000000010101
1100000000000C00000000100000000100100010000000000001100000000000000100X01C100000100000010000010000C1
10000100100000000110000000000100C000010000000010001001000X010000111001100000000000010100X01001000C01
10000001000000010000101000000000001001010000001011000X000000C101100X100C010X000000001100000100000001
10000000000C100010100000000000000000101X00000000000000000011C0000000000010000100110100001C0000100001
1110C101C000C0000000C0000000C0C0C101000000C100111000000000000C01000100001000000000110000010000111001
10001000010101100000000E100000010C10000100000XX000010000100010000000C010C0100010C0C11010001X000001C1
101000000011010001000000001010X1000000000000100000000000000000X0C10000000001000000101CC1000000000001
10101101X0000001001100C0001101C100X001000000C0010001100000100000001010110001X00000001001100000010001
1001000000000001000010C00001111000100010000000000000001X0110001010000000C00001000000000000000C001X01
11010100001C100000C000001000000000C100C00100010110X0000000X0100000100X00000C000111000000010100000101
100C0000010100000011C00C0010C1000001000010010001001X001000C10000000000000100001000010000010000110001
1000100C0111000001000110C1010000001000X00000010010X0000100000000010011000000001000C00100000000C00001
100010C0000000C000000101000101X011X010000000C0100010001C00010C0C11100000000X00000X10X000000000000011
110000010000C00011000000010100000000000000000000C00C00000000000001X00000001C00CC0C1C100C000000C11011
1010101000000X00001000000000C0000001010C0100C000010001101C01C0110000000C1X00000X01000C10C000101CC001
1000000X00100100100001100010000000000010000000001001100000100000010X000010C01100101XX00000000000C0C1
101000100000001X000000X10000000000C00000000110001100000100000000000000000011C0110X010000000000001011
11100000110XC010010000000000001C01100000000000000C00000001001011C1000100100000010C000000110C000X0001
1C0000100011010101000000100001C010C00CC0C000100100C110C001000C0000000000101001100010000C000XX0000101
10000001010100000010100010000011000000000010100000000X1100000000C00C1000100000000000000101000101C101
10010C00C100001X0000100000C00C1001C00X0000000010001C0101000000000000000X000110000000C0010001001010C1
110000100C100X1001000000000000000X0C000011011000001000000000000000010100010000100000X000100010001C11
11100000000010X01000000C00000000CC0001X00000000100000001001X0C0000C00000101000011000C100000X00000001
1001100X0010000100000000000010000000110000001000000000000C000X0C00C110C00000000000000000000110111XX1
10C101X0011C10C0010010X01000001000100000000C1100010X0000001001011000001100110C0000100011000000100101
1000000X001X0000001010C000000010010000000001C001C100000000000010000000000010001000111000X10101010011
100C0X0001X0000000C001C000C000000001100X00000010C100000000010000011110100000010001000CX0001001000001
10C000001010010X0001100010000000100000000C00000000010100000000010000011001000000C000010001001010CC01
1000110001000X1110100010C0010000001000011100010010000000000010000C000001000C0000C1001010010100C00001
10100001C0001010100010011000000010100001C00000000000101CC00C00C0X00X0000000000C000XC000C1000100X0011
1000000100001000C00C1000100011X01X0000C00000001000010001000101000C1111100C0000C010010000CC0000000101
111000001001C00000000100000100000011000010000001CC0010000000001101000001C11XC0C0000C0C0000C010100001
1111111111111111111111111111111111111111111111111111111111111111111111111111111111111111111111111111