111111111111
11C110101001
1E000X001001
101001000001
1100C1P00C11
110C00001011
111111111111