11111111111111111111
10000C001C0000000X11
1100000C100000001001
1000C001110000001101
1000C100000000011101
10100010001000001001
10000000000C01000001
11100001101000000001
10C0C100000000100001
1100C0010000000100C1
1000000000000C000001
1XCC00001000X1000011
10000000100000100101
1100001C100000010101
10000101000000001001
100C0010010000000101
100000000010X0001001
10101101000X11110001
1C000001110000100011
11000100000000000001
10C10000101000C10001
11001001010101001101
1000100000101100X101
1X001010110110010011
1C00001C00000C000001
100001100C0001000C01
100000000000X1001001
100000000000000011C1
1000001CC10010011001
1000101000000X0000C1
10C01X0100011000C001
10000100000000000001
10000010010C000C1101
1X001000000011100011
1010C0100001C00C1C01
1000000000010C000001
10000011001001C00011
10101100001000000001
101C00000C00010000C1
10110111010000001001
1100000000010X000101
11000000111010110001
10100000000100000001
1X000000100010C01001
10100000100000100011
111X0000000110011001
10C10001000C00010111
10001X11001000X00001
100000000000000011C1
10000011100010C00111
10X00000011010000011
101P010CC1000C000101
100000100CXX10000001
1000101000101C1C0011
10010010010000000001
10010100010110000101
11010110110100011001
10X000XX00C000000101
101000X0101100000001
1010001C000C10010111
1C001001001100100101
10000CC10110C0000011
1000C100100100001001
10000000010000010001
111000000000000X0011
10100010100100000001
11C0X000101100011001
10C00010001C00000101
10000000101001001001
1000000011000000C001
1C000001000000X00001
10001000000001000C01
10000CC0000000000001
1000000010000001C001
11001100000010100001
101101000X0000C010C1
100000011C10000000C1
100100100001001C0001
101000010000010100C1
10010000000001101011
10100100010001001001
10010000C00000100001
10000C00000100110001
100010100100011001C1
10001000101C00101001
10001C000010000C0001
1000100000C010001111
1000000100100X100001
101100001100010000C1
10100001111000C10X01
101C0110000000000001
1X100001000000C10011
10000C000000C00X0C01
1000000C1C0011001001
1100CC0000000C110X01
101010010X0010000001
110EC001000000001001
10000000000000000001
10000100010000000X01
110111C100C100000001
1X00100100C000011101
100000000C0000000101
11001010010011X00001
10010C0C0X0100100001
1000000X00000C00X001
10C01001110101000001
100C1101C00011000001
100100X11000000C1001
1001000001X000100011
10000100X0000C000001
10010000011C0C0C0101
100001C0001101100001
1100000001000000C001
100C0000000001001001
1C001100000C00011011
10000010X00010001001
1000100X0C000001C001
10C10100101C11000001
11000001000000001101
10000011110C0010C011
100X0C10000110000001
1C00000000C000101001
11C001100000010X0001
1010100C111010100001
101C0000100100010C01
10100010000X0C000111
100CC01011XC00000011
1000000010000C00X101
10000000110000001111
10000010001011000001
1010000CC10001001101
11000000000011010101
101110C0010000100CX1
1100011X1000000C10C1
1001C1000001001C1101
10101010000000C11001
1000110X00000C000001
100001C1000000000001
1X000000000000001011
11000000101000000001
10000100000000000001
100C0000000010101011
10110000000101001001
1C000101100100CX1001
10010000000000010011
1C00C0C0000000000001
10000000100111100001
1000C0010CXXX0000001
1000000000001001C011
100X1011CC0011000001
10100000100001100011
1010001000000010C0C1
10000010100000000001
101X0000100C00110001
10000000C01X00000001
100X0000000110001001
10000000000010X00001
1C1010000000X0C00001
10000000C10001100001
10000X01000000000001
10100001000001100001
11000000000001000101
101000100011X0000C01
1100000010X1000010C1
10001000100001001101
10C00000000000000001
11100001001010101001
100C000C000000000001
1001C0C00100C0110001
10000001001C00C10001
100001C00000000000C1
10000010C010000C1101
1000110C100000100001
1100000000C0X0C1C101
10010100100000000101
11000110000011001011
10010X000010000000C1
100C1100011010000101
101110000100000CC001
1000100X101011X10101
1000C100111010000011
10XC01000000C0010011
10001000000010000001
1000100000C0100X0011
1010100X100000010011
10011000100000000001
10101C00010000010001
10100000000010111001
1000X0100000X0000001
100110100C0000001001
100001C00000X0000001
110000000011010C1001
1100C100100100000001
110000000000X01000C1
10010C00000C0X010001
1100001010C001000001
100000100000C10C0001
11000C100000X0000001
100010000100X000C011
11111111111111111111