11111111111111111111
10001000000001000001
10X00000100100010001
10100X00000010001001
1E000000000000100001
10000001010000000001
10P01000X0100X000001
10100000010000000001
10000100000001000001
11111111111111111111