11111111111111111111
100011000000C000X011
1000C000000C000C0001
10000011011C001000X1
10100010000000000101
10000000010000001X01
10000000C00000C0C101
10000000000000000001
10000CP0XC1001000111
11111111111111111111