11111111111111111111
10100000C01000000101
1000C000000000111101
1000001C011000C00001
110000C0X00001000001
10C0E0010C01000C0001
100000X00000C0000X01
10C00100000000000011
10100110X00000000001
11111111111111111111