11111111111111111111
10000011X00E000000C1
1000000000000C101001
100C0000C1000C000100
100010000010X0100001
110000000000X000CP01
10C0001100CC00X01001
10000000000000001001
1000000100000C011001
11111111111111111111