111111111111111111111111111111111111111111
100100000011CC0001000001011000000000010001
100X001000001C1000000000C000C1000000011001
1000C001000C10X00C001000C001X0000001100001
1100000100010XC000011110000001000100110001
101110000000X10C0100010000000C000000000001
100000C1101X0X0100C00001C00000000000000101
1001C100C01010CX01001100000110000000011001
101010110100000000110001000000010100000C01
100011000000C00X000010000001C11100000000X1
101111100000000010010000001000X01C0C000C01
101101000100100010000100001000C00010000CX1
1001C00000001C0010000110100111001000010101
1000001000011100100010010000000C0000000001
100000100010010000000000001001010C000000C1
1000100000000000110C00100100E000100100C001
1C0000100000011100X01011101100010000001001
1000C00X100X00101001C001010000001000010011
1100010001001100110000001X00001000C1010001
1001000011C0010000000000000000000000000011
110000C00000110010000100000000100XX0000001
101000000010010000000011C00000C1000CC00001
11C0000010000000000101P1C000000000000C0101
10000010010101X0C0001C00000000100000110101
100000100000000011101C01000C0100000X001101
10111010001C0101000C10000X0010C00001000001
101000CC01C000010001000C01C00C001001101X01
10X00110010100100000000000C0000X000C001001
100100000000001100000000011000X101C11C0101
111111111111111111111111111111111111111111